|======================================================================|
|                                                                      |
|                                                                      |
|                                                                      |
|                                                                      |
|                                                                      |
|                                                                      |
|                                                                      |
|======================================================================|
|                                                                      |
|                                                                      |
|                                                                      |
|======================================================================|
|                                                                      |
|                                                                      |
|                                                                      |
|                                                                      |
|                                                                      |
|**********************************************************************|
|======================================================================|