*************************************************************************
*                                                                       *
*                                                                       *
*                                                                       *
*                                                                       *
*                                                                       *
*                                                                       *
*                                                                       *
*                                     --------------                    *
*                                     *         ,-~¨^  ^¨-,           _,*
*                                 ----*       /          / ;^     .,¨/  *
*                                     *      /          / /         /   *
*                                     *     /          / /         /    *
*                         *-----      *    /          / /         /     *
*                -----    *           *   /,.-:''-,_ / /         /      *
*                         *       ----*               ^:-.----../       *
*                    *    *           *                                 *
*--------------------*    *------------                                 *
*                    *    *                 _,.-:--._                   *
*                    *    *          *    /^         / /¨:.._¨__.;      *
*                    *    *      ----*   /          / /      ^  /       *
*                    *               *  /          / /         /        *
*                           --       * /          / /         /         *
*                                    */_,.--:^-._/ /         /          *
*                     -------------- *^            ^¨¨-.___.:^          *
*************************************************************************