|======================================================================|
|                                                                      |
|                                                                      |
|     =================================================================|
|     *****************************************************************|
|     =================================================================|
|                                                                      |
|                                                                  K   |
|                                                                      |
|======================================================================|
|**********************************************************************|
|======================================================================|
|                                                                      |
|                                                                      |
|                                                                      |
|                                                                      |
|                                                                      |
|                                                                      |
|======================================================================|