00000000000000000000000000000000O0000000000000000000000000000000000000
00000000000000000000000000000000O0000000000000000000000000000000000000
00000000000000000000000000000000O000000000000000*000000000000000000000
--------------------000000000000000000-------------00000000000000O0000
0000000000000000000|000000000000O0000000000000000000000000000000000000
0000000000000000000|000000000000O0000000000000000000000000000000000000
0000000000000000000|000000------------------000000O0000000000000000000
0000000000000000000|000000000000O0000000000000000000000000000000000000
00000000000000000000000000000000O0000000000000000000000000000000000000
00000000000000000000000000000000O0000000000000000000000000000000000000
-----------------------------00000000000000000000000000000000000000000
00000000000000000000000000000000O0000000000000000000000000000000000000
00000000000000000000000000000000O0000000000000000000000000000000000000
00000000000000000000000000000000O0000000000000000000000000000000000000
00000000000000000000000000000000O0000000000000000000000000000000000000
0000000000000000000000000000000000000000000000000000000000000000000000
0000000000000000000000000000000000000000000000000000000000000000000000
0000000000000000000000000000000000000000000000000000000000000000000000
0000000000000000000000000000000000000000000000000000000000000000000000
0000000000000000000000000000000000000000000000000000000000000000000000