                        | |            | |                            
                        |-|            |-|                            
                        | |    \ /     | |                            
                        |-|    \|/     |-|                            
         o              | |     o      | |                            
        /|\             |-|            |-|                            
        / \             | |            | |                            
------------------------|-|            |-|                            
                        | |            | |                            
                        |-|            |-|                            
                        | |            | |                            
                        |-|            |-|                            
                        | |            | |                            
                        |-|            |-|                            
                        | |            | |                            
                        |-|            |-|                            
                        | |            | |                            
                        |-|            |-|                            
                        | |            | |                            
                        |-|            |-|                            