|------------------------------------------------------------------------------------------------------|
|                                                                                                      |
|                                                                                                      |
|                                                                                                      |
|                                                                                                      |
|                                                                                                      |
|                                                                                                      |
|                                                                                                      |
|                                                                                                      |
|                                                                                                      |
|                                                                                                      |
|                                                                                                      |
|                                                                                                      |
|                                                                                                      |
|                                                                                                      |
|                                                                                                      |
|                                                                                                      |
|                                                                                                      |
|                                                                                                      |
|                                                                                                      |
|                                                                                                      |
|                                                                                                      |
|                                                                                                      |
|                                                                                                      |
|                                                                                                      |
|           |                                                                                          |
|           |                                                                                          |
|~~~        |                                                                                          |
|           |                                                                                          |
|        ~~~|                                                                                          |
|      ~~|                                                                                             |
|    ~~|                                                                                               |
|    |                                                                                                 |
|------------------------------------------------------------------------------------------------------|