|------------------------------------------------------------------------------------------------------|
|                                                                                                      |
|                                                                                                      |
|                                                                                                      |
|                                                                                                      |
|                                                                                                      |
|                                                                                                      |
|                                                                                                      |
|                                                                                                      |
|                                                                                                      |
|                                                                                                      |
|                                                                                                      |
|                                                                                                      |
|                                                                                                      |
|                                                                                                      |
|                                                                                                      |
|                                                                                                      |
|                                                                                                      |
|                                                                                                      |
|~~~~~~~~~~~~~~~~~~~~~                                                                                 |
|                    |~~~~                                                                             |
|                    |                                                                                 |
|                    |                                                                                 |
|                    |        ~~~~~                                                                    |
|                    |                                                                                 |
|        ~~~|        |                                                                                 |
|           |        |~~~~                                                                             |
|~~~        |        |                                                                                 |
|           |        |                                                                                 |
|        ~~~|        |~~~~~~~~~                                                                        |
|      ~~|                                                                                             |
|    ~~|                                                                                               |
|    |                                                                                                 |
|------------------------------------------------------------------------------------------------------|