************************************************************************
*                                                                      *
*                                                                      *
*                                                                      *
*                                                                      *
*       *                                                              *
*       *           --------------------------------------            *
*       *            *************************************             *
*---    *            *                                                 *
**      *------      *                                                 *
*       *            *                                                 *
*       *            *        -----------------------------------------*
*    ---*            *        ******************************************
*    ****       -----*                                                 *
*       *            *                                                 *
*       *            *                                                 *
*      -*---         *-------------------------------------------      *
*--                  ********************************************      *
*              ----  *                                                 *
*                    *                                                 *
*           ---      *                                                 *
*                    *                                                 *
*----   -----         -------------------------------------------------*                                                 
************************************************************************
